Level1
300
12 10

#..#######~~
#....#:...:~
..::....:~~~
#..:..~~~~~~
#####.......
...........#
.E......###.
#......::..:
#..#..#..#..
...#:.:..:..

@ 2 4